#########################
#         #     ##     ##
#  ### #  #   #     ##  &
#      #    ########  # #
#  ##### ##        # ## #
#  #          #  #      #
#     ####  ##  #########
####  #  #  #           #
#     #          ####  ##
#   ###########  #      #
###  #     #  ####  #####
# ##    #        #   ####
#      ##  # ##      #o #
#  #  ####      #### #  #
#  #o #     #####       #
#  #### ###  #     ######
#       #       #       #
###### #  ##### # # o # #
#      #    #   # ### # #
#  #######              #
#        #  #######   ###
####  #     #        #  #
#     #  ########  @ #  #
#########################

