################################################################################
#     #           #           #           #           #           #            #
#           #     #     #     #  @  #     #     #     #     #     #     #      #
#     #     #           #           #           #           #           #      #
##   ################################################################  #########
#      #     #           #           #           #           #           #     #
#            #     #     #     #     #     #     #     #     #     #     #     #
#      #           #           #           #           #           #           #
##   ######################################################################   ##
#     #           #           #           #           #           #     #      #
#                                                                       #      #
#     #           #           #           #           #           #     #      #
#####################################################################  ####   ##
#            #           #           #           #           #           #     #
#      #           #           #           #           #           #           #
##   #################################   #######################################
#                 #           #     #     #     #     #     #           #      #
#           #     #     #     #           #     #     #     #     #     #      #
#           #           #           #                             #            #
##   ########################################   ###########################   ##
#      #           #     #     #           #     #     #           #           #
#            #           #           #     #           #     #     #     #     #
#      #     #     #           #     #     #     #           #           #     #
#####################################################################   ########

